60
5111100000
0000100000
0000100000
0000100000
0000100000
0000100000
1111111118
1000100000
1000600000
2000111113
