45
5111111111
0000000001
0000080001
0013010001
1110011201
6000010001
6000010001
6000010001
1111111111
0011111111
