25
5111111000
0000001080
0000001010
0000001111
0000000001
0000003001
0000001001
2116611111
0000000000
0000000000
