35
5111111111
0000000001
2111111111
0100000000
0111111111
0001000001
0008000001
0000011601
3111110601
0000000611
