30
5111111111
0000000001
0081111111
0000000001
0011111101
0010000101
0011110601
0000010101
0000010101
3111110111
